{
    "tiles": [ [0, 0, 1, 1, 1, 1, 1, 0, 0],
               [0, 1, 1, 1, 1, 1, 1, 1, 0],
               [1, 1, 1, 1, 1, 1, 1, 1, 1],
               [1, 1, 1, 1, 0, 1, 1, 1, 1],
               [1, 1, 1, 0, 0, 0, 1, 1, 1],
               [1, 1, 1, 1, 0, 1, 1, 1, 1],
               [1, 1, 1, 1, 1, 1, 1, 1, 1],
               [0, 1, 1, 1, 1, 1, 1, 1, 0],
               [0, 0, 1, 1, 1, 1, 1, 0, 0] ],
    "targetScore": "400000",
    "time": 60
}