{
    "tiles": [ [0, 1, 1, 0, 0, 0, 1, 1, 0],
               [1, 1, 1, 1, 1, 1, 1, 1, 1],
               [1, 1, 1, 1, 1, 1, 1, 1, 1],
               [1, 1, 1, 1, 1, 1, 1, 1, 1],
               [0, 0, 1, 1, 1, 1, 1, 0, 0],
               [1, 1, 1, 1, 1, 1, 1, 1, 1],
               [1, 1, 1, 1, 1, 1, 1, 1, 1],
               [1, 1, 1, 1, 1, 1, 1, 1, 1],
               [0, 1, 1, 0, 0, 0, 1, 1, 0] ],
    "targetScore": "50000",
    "time": 10
}